15 25
-1 -1 -1 -1 -1 -1 -1 -1 -1 -1 -1 -1 -1 -1 -1 -1 -1 -1 -1 -1 -1 -1 -1 -1 -1
-1 1 2 3 4 5 6 7 8 9 -1 1 2 3 4 5 6 7 8 9 8 7 6 5 -1
-1 2 -1 -1 -1 -1 -1 -1 -1 1 -1 2 -1 -1 -1 -1 -1 -1 -1 2 -1 -1 -1 4 -1
-1 3 -1 3 4 5 6 7 -1 2 -1 3 -1 3 4 5 6 7 -1 3 -1 5 6 7 -1
-1 4 -1 4 -1 -1 -1 8 -1 3 -1 4 -1 4 -1 -1 -1 8 -1 4 -1 -1 -1 8 -1
-1 5 -1 5 -1 5 6 7 -1 4 -1 5 -1 5 -1 5 6 7 -1 5 -1 5 6 7 -1
-1 6 -1 6 -1 -1 -1 -1 -1 5 -1 6 -1 6 -1 -1 -1 -1 -1 6 -1 -1 -1 -1 -1
-1 7 8 9 8 7 6 5 4 3 2 1 2 3 4 5 6 7 8 9 8 7 6 5 -1
-1 -1 -1 -1 -1 -1 -1 -1 -1 -1 -1 -1 -1 -1 -1 -1 -1 -1 -1 -1 -1 -1 -1 -1 -1
-1 5 6 7 8 9 8 7 6 5 -1 5 6 7 8 9 8 7 6 5 4 3 2 1 -1
-1 4 -1 -1 -1 -1 -1 -1 -1 6 -1 4 -1 -1 -1 -1 -1 -1 -1 6 -1 -1 -1 2 -1
-1 3 -1 3 4 5 6 7 -1 7 -1 3 -1 3 4 5 6 7 -1 7 -1 5 6 7 -1
-1 2 -1 2 -1 -1 -1 8 -1 8 -1 2 -1 2 -1 -1 -1 8 -1 8 -1 -1 -1 8 -1
-1 1 2 3 4 5 6 7 8 9 -1 1 2 3 4 5 6 7 8 9 8 7 6 5 -1
-1 -1 -1 -1 -1 -1 -1 -1 -1 -1 -1 -1 -1 -1 -1 -1 -1 -1 -1 -1 -1 -1 -1 -1 -1
